1111111111111111111
1000100111000100011
11C00P110000EE00011
1111000CE0010000111
1111111111111111111